ALL	AO L
BATHROOM	B AE TH R UW M
BEDROOM	B EH D R UW M
BLUE	B L UW
DINING	D AY N IH NG
FADE	F EY D
FAN	F AE N
GARDEN	G AA R D AH N
GREEN	G R IY N
INDIGO	IH N D AH G OW
INDIGO(2)	IH N D IH G OW
KITCHEN	K IH CH AH N
LIGHTS	L AY T S
OFF	AO F
ON	AA N
ON(2)	AO N
ORANGE	AO R AH N JH
ORANGE(2)	AO R IH N JH
PURPLE	P ER P AH L
RASPBERRY	R AE Z B EH R IY
RED	R EH D
ROOM	R UW M
WHITE	W AY T
WHITE(2)	HH W AY T
YELLOW	Y EH L OW
